"11-3021"
"15-1121"
"15-1122"
"15-1131"
"15-1132"
"15-1133"
"15-1134"
"15-1141"
"15-1142"
"15-1143"
"15-1151"
"15-1152"
"15-2041"
"17-2061"
"43-9011"
"43-9021"
